NO  ./textures/wall_north_x128.xpm
SO  ./textures/wall_south_x128.xpm
WE  ./textures/wall_west_x128.xpm
EA  ./textures/wall_east_x128.xpm

DO  ./textures/plate_door_x256.xpm
DOS ./textures/plate_door_side_x256.xpm

SQ0 ./textures/sprite_x256_0.xpm
SQ1 ./textures/sprite_x256_1.xpm
SQ2 ./textures/sprite_x256_2.xpm
SQ3 ./textures/sprite_x256_3.xpm

C   40,40,40
F   70,8,8


             111      1111    1111
        11111101111111100111111001
        10000000001100000000001111
        10110000011100000C0000001
        1001000000000000000C00001
111111111011000001110000000000001
1000000000110000011111111D1111111
11110111111111011100000010001
111101111111110111010100DN001
1100000011010101110C000010001111
10000000000000000000000000000001
10000000000000001101010010001001
11000001110101011111011110001111
11110111 1110101 101111010001
11111111 1111111 111111111111
